ANGLÈS > CATALÀ
remove = elimina
delete = suprimeix
erase = esborra
commit = publica
enter = introdueix
set = aplica
save = desa
add = afegeix
clear = neteja
settings = configuració
setup = configuració
required = obligatori
otherwise = altrament
placeholder = marcador de posició
true = cert
loader = carregador
lock = bloqueig  (verb: Bloca)
reload = recarregar
refresh = actualitzar
constraint = restricció
unlock = Desbloca (verb)
restore = restaura
mail = correu-e
cron = cron
history = històric
attachments = adjunts
script = script
insert = inserir
warning = avís
login = inici de sessió
caption = títol
hint = suggeriment
language = llengua
fill = omple
search = cerca
Apply default = Estableix per defecte
log = registre
Log in = Inicia sessió
submit = envia
password = contrasenya
logout = Tanca la sessió
about = quant a
scheduled = planificat
upload = puja
click = clic
ok = D'acord
download = baixa
bulk = massiu
custom = personalitzat
fetch = recuperar
pin = fixar
string = cadena
deadlock = bloqueig mutu
thread = fil d'execució
Stacktrace = Traça de la pila
reset = reinicia
save as = Anomena i desa
cancel = cancel·la
switch = commutador, commuta
count = recompte
average = mitjana
get = obté
tail = cua
summary = resum
see = vegeu
root = arrel, adj:primordial
retry = reintenta
Caps Lock is on = Bloq Maj està activat